11111111111111
1E000000C00001
100P0011000C01
10001110000001
10C00000001111
1000000C000001
10000000000001
11111000C00001
1000C000000C01
11111111111111