111111111111111111111111111111
1P0000C00000000010000C00000C01
100000000C000000100000C0001111
1C00000C000000C01000000000C001
100000000000000000000000000001
1000000C00000000111100000C0001
10000000000000000C010000000001
100001100000C0001111000C000001
10000010000000000C000000000001
100C0010000C0000000000C00000E1
1111101000000000110000000C0001
10000000000C00000000C000000001
10000C00000000000C000000000001
1000000000C0000000000C00000001
111111111111111111111111111111